R 800 640

NO ./textures/NO.xpm
SO ./textures/SO.xpm
WE ./textures/WE.xpm
EA ./textures/EA.xpm
S ./textures/SPRITE.xpm

F 145,134,126
C 149,161,195



1111111111111111111111111111111111111111111111111111111111111111111111
10000001
100N0001
11111001
    10011111111111111111111111111111111111111111111111111111111111111111111111111111111111111111
    100000000000001
    111111111111111
