R 800 640

NO ./textures/NO.xpm
SO ./textures/SO.xpm
WE ./textures/WE.xpm
EA ./textures/EA.xpm
S ./textures/SPRITE.xpm

F 145,134,126
C 149,161,195



        1111111111111111111111111
        1000000000110000000000001
        1011000001110000002000001
        1001000000000000000000001
111111111011000001110000000000001
1000000000110000011101111111111111111111111111111111111111111
11110111111111011100000010001
11110111111111011101010010001
11000000110101011100000010001111111111
10002000000000001100000010001
10000000000000001101010010001111111111111111111111111111111
11000001110101011111011110N0111
11110111 1110101 101111010001
11111111 1111111 111111111111
1111111111111111111111111111111111111111111111111111111111111111111
