R 800 640

NO ./textures/NO.xpm
SO ./textures/SO.xpm
WE ./textures/WE.xpm
EA ./textures/EA.xpm
S ./textures/SPRITE.xpm

F 145,134,126
C 149,161,195



11111111
10000001111111111111111111111111111111111111111111111111111
100N0001111111111111111111111111111111111111
11111111
