R 800 640

NO ./textures/NO.xpm
SO ./textures/SO.xpm
WE ./textures/WE.xpm
EA ./textures/EA.xpm
S ./textures/SPRITE.xpm

F 145,134,126
C 149,161,195



111111111111111111111111111111111111111111111111111111
10000001                                     111111111
100N0001                                     111111111
1111111111111111111111111111111111111111111111111
