R 800 640

NO ./textures/NO.xpm
SO ./textures/SO.xpm
WE ./textures/WE.xpm
EA ./textures/EA.xpm
S ./textures/SPRITE.xpm

F 145,134,126
C 149,161,195




11111111
10000002
100N0001
11111111
