R 800 640

NO ./textures/NO.xpm
SO ./textures/SO.xpm
WE ./textures/WE.xpm
EA ./textures/EA.xpm
S ./textures/SPRITE.xpm

F 145,134,126
C 149,161,195




11111111
10000001
100000S1
11111111
                                 11
                                 101
                                 1 1
