
R 800 640
NO ./textures/NO.xpm
WE ./textures/WE.xpm
S ./textures/SPRITE.xpm

F 145,134,126
SO ./textures/SO.xpm
C 149,        161,195


EA ./textures/EA.xpm


11111111
10000001
100N0001
11111111
               11111111
               10000001
               10000001
               11111111
